0,0,0,0,0,0,0,0,0,0,0,0,0,0,0,0,0,0,0,0,0,0,0,0,0,0,0,0,0,0,0,0
0,0,0,0,0,0,0,0,0,0,0,0,0,0,0,0,0,0,0,0,0,0,0,0,0,0,0,0,0,0,0,0
0,0,0,0,0,0,0,0,0,0,0,0,0,0,0,0,0,0,0,0,0,0,0,0,0,0,0,0,0,0,0,0
0,0,0,0,0,0,4,0,0,0,0,0,0,0,0,0,0,0,0,0,0,0,0,0,0,0,0,0,0,0,0,0
0,0,0,3,0,0,0,1,0,0,0,0,6,7,0,0,0,0,0,0,0,0,0,0,0,0,0,0,0,0,0,0
0,0,3,3,0,0,3,0,0,0,0,0,5,0,0,0,0,0,0,0,0,0,0,0,0,0,0,0,0,0,0,0
0,0,0,3,0,0,5,0,0,0,0,0,6,0,0,0,0,0,0,0,0,0,0,0,0,0,0,0,0,0,0,0
0,0,7,5,0,0,3,0,0,0,0,0,3,0,0,0,0,0,0,0,0,0,0,0,1,0,0,0,0,0,0,0
0,0,1,5,0,0,8,5,0,0,0,0,7,0,0,0,0,0,0,0,0,0,0,0,4,0,0,0,0,0,0,0
0,0,7,6,0,0,1,0,0,0,0,0,3,0,0,0,0,0,0,0,0,0,0,0,1,0,0,0,0,0,0,0
0,0,7,2,0,0,3,0,0,0,0,0,6,0,0,0,0,0,0,0,0,0,0,0,8,0,0,0,0,0,0,0
0,0,4,4,0,0,8,0,0,4,0,0,7,0,0,0,0,0,0,0,0,0,4,0,5,0,0,0,8,0,5,0
0,0,5,0,8,0,5,0,0,4,8,1,3,0,0,0,0,0,4,0,0,1,1,0,4,0,8,0,7,5,5,2
0,0,2,0,7,0,7,0,5,5,0,5,6,2,0,4,0,4,7,0,5,6,3,4,3,1,3,0,6,6,0,0
0,0,6,0,2,0,1,0,7,0,3,0,6,3,5,5,5,6,7,0,7,0,3,0,5,8,1,7,1,7,7,0
0,0,5,0,3,0,6,0,1,3,0,0,2,0,1,8,0,2,2,0,1,4,0,7,6,4,7,6,3,4,3,0
0,0,8,0,3,0,7,0,4,1,0,0,6,0,4,0,2,2,7,6,5,0,5,1,5,3,8,0,3,3,1,1
0,4,0,0,5,0,3,4,3,0,0,8,0,0,4,2,6,0,8,4,8,3,3,1,1,1,0,5,2,0,0,5
0,0,8,0,6,0,4,0,2,0,0,5,0,0,4,0,5,5,6,1,2,0,5,7,8,1,3,2,0,3,5,3
0,0,7,0,5,3,0,0,8,0,0,8,4,0,5,4,0,4,0,8,6,0,0,0,6,0,3,0,0,0,8,7
0,0,8,0,3,5,0,0,0,3,0,0,8,0,0,8,0,0,0,1,2,0,0,0,0,0,0,0,0,0,0,0
0,6,0,0,5,7,0,0,1,6,8,2,4,0,0,3,0,0,0,8,0,0,0,0,0,0,0,0,0,0,0,0
0,4,0,0,8,5,0,0,0,3,2,0,4,0,0,0,2,0,0,0,0,0,0,0,0,0,0,0,0,0,0,0
0,2,0,0,1,4,0,0,0,0,0,0,0,0,0,4,0,0,0,0,0,0,0,0,0,0,0,0,0,0,0,0
0,0,0,0,0,6,0,0,0,0,0,0,0,0,0,0,6,0,0,0,0,0,0,0,0,0,0,0,0,0,0,0
0,0,0,0,0,0,0,0,0,0,0,0,0,0,0,2,0,0,0,0,0,0,0,0,0,0,0,0,0,0,0,0
0,0,0,0,0,0,0,0,0,0,0,0,0,0,0,4,0,0,0,0,0,0,0,0,0,0,0,0,0,0,0,0
0,0,0,0,0,0,0,0,0,0,0,0,0,0,2,5,0,0,0,0,0,0,0,0,0,0,0,0,0,0,0,0
0,0,0,0,0,0,0,0,0,0,0,0,0,0,0,2,0,0,0,0,0,0,0,0,0,0,0,0,0,0,0,0
0,0,0,0,0,0,0,0,0,0,0,0,0,0,0,0,0,0,0,0,0,0,0,0,0,0,0,0,0,0,0,0
0,0,0,0,0,0,0,0,5,4,0,0,0,0,0,0,0,0,0,0,0,0,0,0,0,0,0,0,0,0,0,0
0,0,0,0,0,0,5,0,0,1,0,0,0,0,0,2,0,0,0,0,0,0,0,0,0,0,0,0,0,0,0,0
0,0,0,0,0,0,1,8,2,2,0,0,0,0,0,0,2,0,0,0,0,0,0,0,0,0,0,0,0,0,0,0
0,0,0,0,0,0,1,2,0,3,0,0,0,0,0,3,7,0,0,0,0,0,0,0,0,0,0,0,0,0,0,0
0,0,0,0,0,0,7,0,0,0,6,0,0,0,0,0,3,0,0,0,0,0,0,0,0,0,0,0,0,0,0,0
0,0,0,0,0,6,0,0,0,7,0,0,0,0,0,5,0,0,0,0,0,0,0,0,0,0,0,0,0,0,0,0
0,0,0,0,0,2,0,0,0,1,0,0,0,0,0,0,6,0,0,0,0,0,0,0,0,0,0,0,0,0,0,0
0,0,0,0,8,0,0,0,0,8,1,0,0,0,0,4,0,0,0,0,0,0,0,0,0,0,0,0,0,0,0,0
0,0,0,0,2,0,0,0,0,6,0,0,0,0,0,3,0,0,0,0,0,0,0,0,0,0,0,0,0,0,0,0
0,0,0,0,4,1,0,0,0,3,0,0,1,0,0,6,0,0,0,0,0,0,0,0,0,0,0,0,0,0,0,0
0,0,0,0,8,0,0,0,0,1,0,0,6,8,0,2,0,0,3,0,0,0,0,0,0,0,0,0,0,0,0,0
0,0,0,0,2,0,0,0,0,1,0,6,5,0,0,5,0,0,8,0,0,0,0,0,8,2,0,0,0,0,0,0
0,0,0,0,7,0,0,0,0,5,0,0,6,0,0,5,0,0,3,0,0,0,0,0,8,1,4,0,0,0,0,0
0,0,0,0,3,0,0,0,0,6,0,2,6,0,0,8,0,0,0,0,3,6,0,2,0,1,8,0,0,0,0,0
0,0,0,0,2,0,0,0,0,1,0,8,0,4,0,7,0,0,0,0,2,6,7,1,0,0,5,0,0,0,0,0
0,0,0,0,1,0,0,0,2,0,0,2,0,6,0,2,0,0,0,0,6,6,0,2,0,2,0,0,0,0,0,0
0,0,0,0,7,0,0,0,6,0,0,6,0,6,0,5,1,0,6,0,1,0,4,6,0,8,2,0,0,0,0,0
0,0,0,0,2,0,0,0,3,0,2,0,0,7,0,2,0,6,0,2,0,1,0,1,3,6,0,0,0,0,0,0
0,0,0,0,0,2,0,0,4,0,1,5,0,8,0,4,0,0,5,0,3,0,5,0,4,5,0,0,0,0,0,0
0,0,0,0,0,5,0,0,6,0,0,0,0,5,0,8,1,4,0,4,0,0,0,8,4,0,0,0,0,0,0,0
0,0,0,0,0,0,4,3,7,0,0,0,0,4,0,0,0,0,0,0,0,0,0,0,6,1,0,0,0,0,0,0
0,0,0,0,0,0,7,6,0,0,0,0,0,0,0,0,0,0,0,0,0,0,0,0,0,8,2,0,0,0,0,0
0,0,0,0,0,0,0,0,0,0,0,0,0,0,0,0,0,0,0,0,0,0,0,0,0,0,8,0,0,0,0,0
0,0,0,0,0,0,0,0,0,0,0,0,0,0,0,0,0,0,0,0,0,0,0,0,0,0,0,0,0,0,0,0
0,0,0,0,0,0,0,0,0,0,0,0,0,0,0,0,0,0,0,0,0,0,0,0,0,0,0,0,0,0,0,0
0,0,0,0,0,0,0,0,0,0,0,0,0,0,0,0,0,0,0,0,0,0,0,0,0,0,0,0,0,0,0,0
0,0,0,0,0,0,0,0,0,0,0,0,0,0,0,0,0,0,0,0,0,0,0,0,0,0,0,0,0,0,0,0
0,0,0,0,0,0,0,0,0,0,0,0,5,4,1,6,2,8,8,3,6,2,1,5,5,7,4,8,0,0,0,0
0,0,0,0,0,0,0,0,0,0,0,0,6,4,7,5,1,7,8,8,2,8,5,3,7,4,2,4,1,3,8,0
0,0,4,7,2,5,1,2,4,8,2,2,0,0,0,0,0,0,0,0,0,0,0,0,0,0,0,0,0,0,5,0
0,0,0,3,5,1,3,2,6,0,3,0,0,0,0,0,0,0,0,0,0,0,0,0,0,0,0,0,0,0,0,0
0,0,0,0,0,0,0,0,0,0,0,0,0,0,0,0,0,0,0,0,0,0,0,0,0,0,0,0,0,0,0,0
0,0,0,0,0,0,0,0,0,0,0,0,0,0,0,0,0,0,0,0,0,0,0,0,0,0,0,0,0,0,0,0
0,0,0,0,0,0,0,0,0,0,0,0,0,0,0,0,0,0,0,0,0,0,0,0,0,0,0,0,0,0,0,0
